55 100
......**....**...*......*.*.*.......*..*..*...................*****.*****..........**........**.....
......**.*.**...**......******.........**.*....................******.**....***...****.......**.....
......***..*******......*.****..........**..**...*.................****....***.....**........***....
.....***.****.****...*.***.****.........*.*.**....*...............*****....****....*.*....*...*.*...
.......**..*******..*.********.........*...********...............*.*****...***...*.*......*........
.......*.....****..*..****..***......***..5*..*****..................*****....*............**...*...
.............*****....**..............****...*..****.................***....**............******....
...........*.*.*...*..................*.***....***..................*.**.*..***..............***...*
............*....***.*........*..........*..............................**..**.*..........*******.**
.................*****.*......*....................................**..*...****9.....*.....*****....
.................******....***....................****............***......*******..*.**....*****.**
...*.............*******..*****...*..**...**.......***..*.........***.**...*.*******.*.*......*...**
..***.**.**.....*.********.****..********.*......****.***.....*.....*****....*.***********........**
*2****.***.........*****..*...*..***********....**.*******....****.*.***...*.**.**...****.......***.
******..**.........****..........***.***.**.....*****.***....****....****...*******.*.***.......****
*****....*........................**......***...*****.........*.**....***...**.*..*.*..***.....*****
.***.............................***.......***.....***..........**....*..*..***.......**......******
..**.*..*..................................***.*...***..........**...........*......****.....*******
......****.....................................**..***..........****.*.*.....***......**.........*..
.....*****......................................******...........*******......*.......**............
****....*.......................................*.****.**.........*****.**...........***.**......**.
****.....*................**......**.............**..***.*.......****..***.............*.******..***
****....**...............*.***.*..****...........*******.*...*...***..................*********...**
.**.*.*..*.*..............**..**.******.........**...***..*****..*.....................*.*****...**.
.....*....**..................***...**..........********..*.****....**.*.............**.*****.....*.
...........**...*****.......*.***.**...........*.***.***...*.*.*.....***...........**.6**...***.....
......*.....*...**.****......*.....**..........*********....*.....*..***...........*****.*......*...
.....**........***.*****....*.*.*.**.*....****...***...*.........*****...........*****.****......*..
.*....**......*.*..**..**.**...*..****.....***....*****........*****..............***.******.....*..
***...........**.......*.**........***......**......**.........***....................**.**.*.......
**...........**.**......**.**......**.*.............*.**.......**..............*......**......*.*...
*.*.........*..****....*******......**....*...........**.......**............***.....***.....***.*..
...*.....*.***..*.....*******.*.......*.***..................................****.*...........***...
.....**.***.*.........****.*.........*.***.....................*............*.****...........*.**...
*4..***...............**............****.*......................7.....**.*.**..***.........**.***...
***.**................*............******......................**.*....*.**.*****.....*....**.......
.*.****.*..................**.......**.*.**....................****...***.*...***....**....**.......
....*.****............*.*..***.......*.****......................*3..*****...***....................
.......**......**.....***..**.......*****........................*.****...*.****..**................
............*.*.**.....**...*.......*.****................................******..8*................
......*......*****....*.*.*..*........****..................***..........*****...*..................
......*.**..******....**...*.*........***....................*....**.......***..*.............***...
....*1***...******...***....*.................................*.*..*..*.....**................****..
...*****...*..*.****.****.................................**.**********...............*.*.*.....*...
..*****.***...***.....****.................................***********................***..**...*...
..*****........*......*****...............................******.*****.................**.******....
..**.................****.....*..............................****.****...............*.*.*.*****....
.**.***...............****...*****........................*..*.*..**..*...............*..*****......
.*...****....***.....******.*****.*.................*....****..*****.*....*..........********.......
.....***.....****.....***.********.........*......*.**...***.....*..**....***.......****.**.........
....***......*****....**....****..*.......***...*..*......*........****...***........**...........*.
.*****.........**.....***...***............**....***.................*...*****......****..........**
..****.................***.***.............***...***......................****.......***........****
...***.................*...*...............**....**.*.....................***.........***........***
..............*****.......................****.............................**........*****.......**.
