27 50
...*..*....***............**...*****..............
....*.*.....**...........***....***...............
.....**.................*.......**.**.....*.*.*...
.**..*...................**.*...*..**....*.3.*....
*****....*....*............**.***.****.**.*.......
*******...*..**......*....*.*****.*.****..5.......
..*****..*.***.......*...***.*****.*****....*..8..
..*****...****.....***.....*..**********....****..
...*.....*...*........*.......*..***.**.....*****.
..**..........*................*..*..........****.
.*****......................................******
*****..............**.........**............*4.***
****..............****........**..............*...
***...........2...***........***.......*****.....*
.*.............9*..***.......***.......****.*.....
...............****.*......*****......*.***.......
...............*****.......**.*.*........*........
*...............***...........**.......****.......
*******.........*****.**....*.**........***.......
********......6.*..7*.***...****.....**.*.........
.*.****.......**********.*..*****..*****..........
..*.****.......********..*......*.*****...........
.*******........**********.........***.*..........
..**...........***......**...*......**.....*......
..*.***.................**1.*.*.....***....*......
....***...**...............***.**....**..***......
....***....*................**......***..*........
