111 200
...........***.**..........***..............***...............***.....*.*.................................**.............****............*.........***.*...*.....*.*....................................
..........***.****.........**.*............****....*......*.******.....***...........*.*..................**..........******......................******.**.......***...................................
.......*.*.***..*****.....*.........*.....*.***....**......*******...*.***.........*****............**...****.......*...**........................*********.........*...................................
.....***........*.**........*........***.....**....**......*****......*.............**.....*...............**......*.*.*...........................****.***.....**......................................
..******.........****......**.*.....*.*...*..***..**.....**.*****....*.*....................**.....................*****.....................*......*....**.....****.......................*.**.........
..***.*...........***......****......*****......****.......******.....******................***...................***.*.....................***....*....*.**....**..*......*******........**.****.......
..****.............***....*.***......***........***......****.**.....*******.........*.*.....*........*...........**.....*..*...*............*.*.*........*...*******......******..........***.***......
.*****...*..................****.....***.......*****...******........**..**....*.*....*.*............***............*.....**.*.**...........*.***.*...........*******......*.****........*..**..........
....*.....*..*.*..............**.....**..**.....****..****.**.................*****..****..**......*****.................*.******..............*.****..........*****........*****...**.********.........
....*.....***.*.*............*.***........***..**..*..***........*...........*******..****..**....*****........***......*..****..**..........*..*****....**..*..**.*.......******....**********.........
...........*.****..........*...****......*.**.****....***........*****.......***.***..*********..**.****......****....*......*.......**.......******....******...***.**..*.******....*.********.........
......***.....**.**...**...*.**.**.....**.*......*....**........******......*.......**..*******....****........*.******.*...*.*...**.*.......***.**......*****...********.****...........*..***.........
....*****......*************.*****..................**.**..........**.......****..***...*.*****.*..****........****.******.*......***..........*........*****.......**********...............*..........
.....******...***.**********.*.*....................................*.......***..*......*...***..**.*.*.........***********.......**......***.*.*......**.****.........*********.**.....................
....**.*.....***.************....................................****.***.....**......*......*....*****..........*.****.**.*.........*...*****........**.***..........**....***..***....................
......*.......**..****...***............................*........*.*******............**...**.*.....****..........****................***.***........*.****.*.............**..*...*...***..*............
..............**.*.........*...................*.......*.*.......*********.............**.**.........**..............*.............*.***.***..........****.....*.........*.....*..........****...*...*..
..............*.*...........*.**.*.*...........*.......*.......**...**..**........*...................*.....*.........*...........******.*.............**.....**...............***.......****....**.**1.
...............***.***.......****.***...........*.....*.*.....*****.....***........*.........*.......*.**..*.....................********....*............*..*.***.............***........***....**.***.
....*....*....*****.*.......***....*............***.....***....****...****........*****.......*.....*.**..*.........................**********.......*.....*.**......*.........****.......*......******.
*...*.....***..*******.....*****..***............***...*.*......*.....****........****.*.............******3.........*...............*******.*.....***.*....****......*.*.....*..***.............*......
.***......******..***.....**.......***..........*.**.****...........******...........*..............*.*.****........****...............*.*****.....**.***.******......**.*.......**.....................
****...**.***.**...........*.........*.............*******...........****.........*....***...........*.***.*.......***...................***.*..*.6***..*******.*.....**..*............**.......**......
*****..****.**...........***.***.....................****...............*...*.....***.*****...*........*.*.........**.......*...........***..*.****....*.*********...**........*.......**.......**......
****....**...........************.....................*.*..................*....***********.**...........*......*..*****...***..........***.**..*.*.....*.*********..**........*.......***....*.*****...
**.......**..........*****.***.......**...............**.....**..........****...*.****.*.****..................********....**..........******....*.......*.********.***...*****..**....***......*****..*
.*.................*****..****......**.................*....***.........*****....**.....*.***...................*****..*...............*..***...........***************.*********.**...*....*....******.
...............*...*****..***......***.................***..*.*..........***.*..*........*****.................****................*......**............*..************.******.****.........**.*.*****.*
............****.....***.***......****.*...*.....*.........*..............***.**.........**..................**...*............******....*................***.**......**.****.***.........*******...***.
...........***...........**.........***...**...***........*................*.**..........................*...**....****........**..**..****...........................*...*****.*.......*.*******....*..
..........***..*..*......****.......**.**...*****........**..................*.*........................**..***..********.....*.*.....**.*.......*.**......................**............*.**.**.*......
...........*********....*.**.........**.....***.**........*.................*............................*****...*.*******.....**.....*.*......***.****..................*****...........********.......
..........****.***.*....**..*.......***..*...*****.......***...........*.................................*.***...***..***.....**.........***..*********..**...............*.*..........*******.*..*.....
.........******..*..................****.***.*.**...*.**.***...........**.........................**.............****..*...***.*..***....****.*.***********............................*******.....**...
..........***.......................***...******....*..******..........**..............***......****........*...........********...***..*.*.*.***...**..****...........................*.*****....***.**
............*......*.**.*................******....***.*****.........*...*...........******......**.*.......*...........*********..*.*****.*******.*...................*.................*****.....*****
...................*****.................***...*..***................**.***.............**.......**.*.......**.**.......*********..*****..**.***....................******.*...........***..**..*...**.*
..................*****..................*..*.....****................****.....*......**.*............*.**..*.***.......****.....*...***..***...........***........***.****............**.*.**...*...*..
.....................***...................**.....*.**....*...........****....**......***..............*.**********.....***......*...**...**...........****.........***.***....................***...*..
..................**....*..................**.**.....**...**............*.*....**.....*.*.............**.**..****.*.......**..........................****..............**...*....*.......*....***..****
...................****..*...................***.....**...****.........****.*****.....**.............*..***.******.**.....*.............................**...**...........*.**....***...****...***.*.***
..................****.*..................***.............***...........*.**.*.****.***........*.....**...*******.*.******...........*...............*.**..****...........**.....***.....*..*..***..****
..*.**...........********.................*****........****.....*............*.*.**.***.......**.....*********.*.*..*****............**....*......***..**.**.**...........**.....***..****......*.***...
.***.............*****..*.**................****........*........****.......*.********......*****....****.****........****..*...*.....***..*.......******..**.............***.....**.****.*......*.*....
.****...........*******.****..*.............***..................***.........*******.*.......****..**..***.**....*...*********..**.....****..**....*.***...**.............*.*....***..**.*****.******...
..**...........****.......**..****.........****...........**....*..**.......*******...........****.***.*.*......**...*****.**..***.*...***..***.....*.**...**............*................*.**.******...
...............***......**.*.****.......................***........*.........******..............****..**......*.......*.....******.*..*....**.......****.****.........**..................*.**.****.***
.**..*.........*..*.....**....*****................*....***.................*.****....*.*........****.*.*....*.*......*.......**.****...*............**********........*...................**.****.....*
.*.*****................**...*...*...........*....*....***................***.*.**..**.******....****......**..*....***..........****.................*.****.*.....................*..................*.
.....***...................***..*.**........*.*..****...***..............*****.*******..******...****......*.*......***.*.......***................................................**..**..*......*....*
....****....................*.*..*......*...**..******...................***..******.*..******.****................********.....***.*....*.........................................****.***.....*****...
...****.*...**.............*****.......*.*...*.*.**......................*.....********...*****.****..............*..*******....*.***..****......*..*..............................***.**.**..******..*.
....***....***.**...........***.*.......**....***.*.................*....*.....*.*...***..****.*..*....**........**.********......***..******....****........**..*.................****...*********.**..
.....***...*******..........*.*.....**.**.....****..................***...............**********......***.......******.***.*......*...*****.....****.........****............**..*****.*..********..**..
...........*********........**.*....*****......***..................**................*.*.*******.....*.*.........**...****........*...*****.....**.*.........***.............*******.....*...*****..*..
............**.******.......**..**..****......***..................**.*..........*.......*****..*.................*....**..............*******...***...........***....**.......*...**..........*****....
.............***.**..........*****.***.**.**....*..................**.............*......*.*..............**...........*.......*........*****.........................*.*.........***..........**.......
........***..*.*..............***.***..******..*......*.**.......................**.....................*****...................**.*.....**.*..*......**..............**..........**....................
.......**..*.........*....**.*.***.********..........***.***....................***.....................*****.*.................***.....**..***.*.....****.....****..****..........*..**................
***...***.........**..*...***.*.******..**......*.**..**..***...........***.....*.*****.................******...............................*****......**.....***.*****.......*****.****...............
.****..**.*......******.******..**..****.***..*.****......**............*****.....******....*****...........*...................***.........*.***.*...*.*......****.*****......****..****...............
****..**.*.......****....****.***.*******.**...*****....................****......*.*........****..............................*****.........**.*...****..........***..***......***....*................
**................****..*.*******...*.**.*.***.*..9**..**..*****...........*.................*****....*....*...................*****........***.....***..*.........**.**..*.............................
...................**......****..*.*.**..**.******...*..*.*****.*............*.**............******..****..**...............*.***.**.......***..*.....*****.........****........................*.......
......****...............****..*..*****.**..*****........**...**............***.*..............***....*******.....*........*****..*.......*.....*2...****.***.......*****......................*.*......
......***..***.........******........*.***..*****......*****......**.......******...............***.*.*****...*****.......*****...........**...****.********.........****..***..................**......
.......*..*.............***..*.......*..*..*******....******.......**.....******.................********.*....***........********...*.******...***....**.***.........**..*.***.........................
..........***..............***.......*...*...******..*******.......***..***.****.................*******...*....**......******.***.**..**..******......**....*.*............****........................
........******..............*.......**......******..*.***..*.........****.*...*...........**......*.***.....*..........*.**********.*******...........***......**...........*.*.........***.............
........*.*****.....**.......*.......*......*******..*****.......***..*.***..............*..*....*..***.....**.......******....***...*****.............*.......*..............*..........***............
.*.........**..*..***......................****..*....**.*.*...****......*****....*........................****.......*****....***..******.......*..............*...................*....***....*.*.....
**................**.*.....................****.*........*****..**........***...*****........*.............******.......**.....***..*******.....*.*.............***.............**.*...........*.***....
*..............*........***......*.........*****.........***.....**.........*.**.*.*..........8*..........*..***........****...**..***..****...***.*............***.............******........**..***...
*...............*.......****....***......*********...........*..***...........**.***.......**.**.....*......**.**...............*...*...*.*****.**.*...........****..............****.........***.*.....
....*.........****.......***....***.......***.****...........******.*.............***...*****.**.....**........*...*.........*.**.*.........*******............*****..............****.........*.*......
..****........****........*.....***............***...........*.*.*****...................********....*...........***.........*****...........*****.................***..............***...........*****.
.*****........***........**.....**...........******..............******..**...........**..*.****.*.*.....**......***..........***...........****...................*.............*..*.*..........***.*.*
*******.......*............*......*..........*.*****............*******..***.....***.****....**..*5*....******....***........****............*....................*.........*...*...****..........******
.**.***.......**..**......***.**..*......*.......***..............*.**...***.....*******.....*...*.*....*****.....****.......*****...........*..................******.......****..*.*..........***.*.*.
.*******..........***...**.******.*....**..*...**..................***............****.*.....*...........*.***..*.*.***.*....**.............***.................*******.*...******..**...........**..*..
.********.........*.......******.**....*****.......................*..........**..****....................**....****.***.*.****............*****..*............**...*****...***.****.**.............*...
..*.**..............*...***...*****......*.............*............**.......**********.......****.......**.....**********.***..............**.....*..*.......*.***.*..***.....******.........*.*.......
.....***..........***...*****.****.......**...........**.............*.......**.**.**.***......***......**........*.***********....................*.***.......*.*....*.**.***.....*..........****..**..
.....******........**..*.*****.**.*.......**.*........**.*.......*****.....******.*****.**.....*.*......*............*..********....................***.**....**.**....********..............*.*...***..
......****......*..**..*..*.*..*.*.........****........***........******..*..****...***.......******..*...............********.....................*.*******......*..*.*******....*.*........**...****..
....*.**........***.*...................***.**...**....***.........*******...**...............*.****..**................*****......................*..******.......****.***.*......***........**....**..
....***.........*****....................*........*.....*........****.**......***...*........******...*.................****.**........**..........*4.********.**.*.****.*.**..*...*.................*..
....****........*****...............................................*.*........***..*........*.***...***.....................**..........**.....*..**...******..**.**.**.***..***.*.....................
....***.*.......****......................................***..**..***........*....****..........**..*****....*..........********.......****.....**.....*.***..**....**..***...***......................
...******.................................................****..*...**...........*****...........*.*.*......***..........**..***........****...*..*....******......***.........**.......................
...*****...................................................**..*.*...*..*........****....*.......****.......***......**.***...*..**.......**...****...*****.......****..........*.......................
...**................................*.....................****.**......*.*........***...***......**...........*......*..**.....****...........*****.*.**........***...........*........................
...*................**..............*****...............****...**......******.......*.....***......**...............***..***....*.*.*...........***...****......***...............................*.....
..**................***.*............*****...............***.*****.....******...****........*......*..................*..****...............******.*...****....***...............*............*****.**..
..***................****............**.***.............******.****.....*****..******.......................................................*****.*.7*****.*..*.***............***.............*******..
..**...*.............*****..............**.**............*****.***.*...***...********................................**.*.........**.......*****......*.*****.....*..........*.***............*******.*.
......*.*...........*.***..............**....*..........*****..********.***....*..****.................................***...*..**.**.....**............****.................*****...*.....*...****.*.**
..............**......**...............*.......*..***....***.*...*****.*******......**...................**............***...*.****......****.............*...................***.....******...***.**..*
...............*...............................*****.*...*..*.....*.*.******.......*.*.**...............*.**............*.*.*.****........****................................*..**....***.*....****....
.........**.****................................*****.*..*.*.......***.**.**...........***..*.**.*.*.*...***...............*.***.........*.***..................................*..*..***........***..*.
..........**.****...**....................**....*****..**.**.....***.....*****.......*****.*.******.**..*****.***........**.****.........*.***...................................................***.***
........*.*..****...*.....................**.....*.......***.....**.....*****........******.*****..*****.**.*..**.......******..........**.*.......*....***............*....***.......*.........***..***
.........****.**..*****..................****............******.........****.........***.*****..**.*.****...**............*.*.........*****.......*.***...**..........**.....*.........***..**..**..*.**
...*.......**.**.*.***.....................**...............***.........*****............*****.....******..***............***......*..******.......****....*..........**.....****.....*******...***...**
****.......*****....****.........***........................*.......*..*.**.*......*.....*.........**.**...****...........***.....*....*.**.......*..**................**.....***......*...**.***.......
............***.....******........***....*........*..................**...*......**...........*...*.***...*.............**.*......*****..............*...*........*..**..*.....**.......*...****........
............*..**.*..****.........***..*.***.....****...............**.*.........***.........**...**.*.*...........*.....***......**.*..................***......*....*......****......***...*..........
..............**.***..***......******...****.....*****.............******........**.*........**....*****...........***.*****.......*...............**..****.....***..**....****...**.*****..............
............*.*****...***.......*****...**........*****.............*****.*...****...*.......****.*......................****.....................***.*.****...***.........**.....**..***...............
............*******.............*****....**......*.****..............*..***....**............*...*.......................***..................***.*.**..***..**.***.......****...****.**................
.............**.**.............*.****....**.......***...................****....*.................*......................**...................****......**....****.......**..***.******.................
